222222222222222
210333033303332
202323232323202
200303030303032
232323232020202
230000303030002
232323232323232
203003340003332
202320202320232
233330033000032
232020202323202
230333003333012
222222222222222