222222222222222
210333000030002
202020232320202
200300333033002
202323232320202
233003030300002
202023232320202
230303343330332
232320202020202
203030333000332
202020202020202
233333333333012
222222222222222