222222222222222
210030333030002
202020202020202
200303030303032
232323232020202
230033030303002
202323202020232
233003340030032
202320202320232
233330033000032
232020202323202
230033003300012
222222222222222