222222222222222
210030303030302
202023202023202
233333333300002
202020202023232
200333033003332
232320232020202
200330043030332
232320202323232
203030303030302
232320202023202
230333330300012
222222222222222