222222222222222
210000300033332
202323202023202
200300330030032
232323232020202
230033030303002
202020232023232
233333343330032
202320202320232
233330033000032
232320232320202
230303003333012
222222222222222